So you can communicate with each other

..or shame people for not showing up :) jk

(message me if you prefer a nickname or something like that)

Algorithms class student list:
zsmith - Zack Smith
obelange - Oliver Belanger
lbogar - Lou Bogar
bhinnega - Brian Hinnegan
imurawsk - Ian Murawski
kcheung - Kenneth Cheung
rnowell - Robert Nowell
slee - Stephen Lee
vportell - Vincent Portella
vyudushk - Vlad Yudushkin
anieto - Abraham Nieto
jshi - James Shi
tpadilla - Tony Padilla
jrameau - Nick Rameau
jaleman - Jose Ramon Aleman
hkalia - Habib Kalia
mwilliam - Meghan Williams
mgould - Matthew Gould
dnelson - Dan Nelson
nnguyen - Kay Nguyen
kmaitski - Kevin Maitski
iiliuk - Julia Iliuk
bburnley - Brian Burnley
myoung - Mason Young
zbeasley - Zach Beasley
lgutniko - Liliia Gutnikova
hkunduru - Hanu Kanduru
tjose - Tim Jose
rle - Ryan Le
yli - Yixin Li
mhurd - Matt Hurd
pmakhija - Piyush Makhija
kromain - Keenan Romain
mroen - Max Roen
azimina - Nastya Zimina
bpatel - Bhavik Patel
pkreitz - Paul Kreitz
cfredric - Cameron Fredrickson
ofedorov - Sasha Fedorova
dhuang - David Huang
shicks - Shawn Hicks
ssalaues - Salim Salaues
dye - David Ye
imoran - Isis Moran
whickey - Wade Hickey
marahimi - Majid Rahimi
yherrera - Yangyang Herrera
bpezehsk - Braden Pezeshki
irhett - Isaac Rhett
eliu - Ezekiel Liu
wasman - Torrey Asman
ppatil - Prateek Patil
tpan - Thomas Pan
tbisi - Tomas Bisi
